111111111
100111111
1S00E1111
1P0011111
100001111
1C0111111
1001C1111
111111111