111111
100111
1S00E1
1P0011
100001
1C0111
1001C1
111111