1111111111111111111111111111111111
1E00000X0000000C00000C0000X0000001
101001010010000010100100000X010101
1010010010101010001001000000010101
1P0000000000000000X0000000000000C1
1111111111111111111111111111111111