1111111111111111111111111111111111
1EX000000X00X00C000000000000000001
1010010100100000100001000000010101
1010010010101010000001000000010101
1P0000000C100000001100000000000001
100000000010C000001100000000000001
100000000C000000001100000000000001
1111111111111111111111111111111111