111111111111111111111111111
101010000000000000000000001
1000P1010010000010000010101
100000001000101000000010001
10C000C00100000000010100000
101000011000C000000101000C1
101000000000C0000001E1000C1
111111111111111111111111111
