111111111111111111111111111
101000000000000C00000000001
1010P1010010000010000010101
101001001010101000000010101
101000000C00C0000001E1000C1
111111111111111111111111111
